td_game savefile
map1
1.1
w15
h15
structure
442444444444444
401000000000004
401001110000004
401001010000004
401111010000004
400000010000004
400111011111004
400101000001004
400101000001004
400101111111004
400100000000004
400100000000004
400111110000004
400000010000004
444444434444444
waves
1C4I
2S2T3I
1S1T3I
1T2I