td_game savefile
map2
1.1
w15
h15
structure
444444444444444
400000000000004
400111100111004
400100100101004
211100111101004
400000000001004
400001111111004
400001000000004
400001111111004
400000000001004
400001111111004
400001000000004
311111000000004
400000000000004
444444444444444
waves
2C2T1S1I1T1C
1C3T1C4I2S2I
2C2T3S5I
1T4S5I
2S4I