td_game savefile
map3
1.1
w15
h15
structure
444444444444444
400000000000004
400000000000004
400011111111004
400010000001004
211110000001004
400000000001004
401111111111004
401000000000004
401011111111004
401110000001004
400000111111004
400011100000004
400010000000004
444434444444444
waves
6I4S2T2C1I
3I2T2S1C3I
1I2S3T
2I2S3C
3S3T3C