td_game savefile
map4
1.1
w15
h15
structure
442444444444444
401000000000004
401000001111004
401000001001004
401111111001004
400000000001004
400011111111004
400010000000004
400011110000004
400000010000004
400000011111004
400000000001004
400000011111004
400000010000004
444444434444444
waves
1I1T1C3S1C5I2T
1C5T4I1T2S3C
1I2S3T
6I5S3T
2C3I3T
2T5I