td_game savefile
map5
1.1
w15
h15
structure
424444444444434
410000000000014
410000000000014
410000000000014
410000000000014
410000000000014
410000000000014
410000000000014
410000000000014
410000000000014
410000000000014
410000000000014
410000000000014
411111111111114
444444444444444
waves
2S1T2I6C1T5I4S5I
2T5I2T2C4S2C4S2I
2S6T2C2I2C4S2T2C
5I5S6T6C
2C2I6S2T2I
1C2I5S1C
3S2T2C
1T5I1T